11,9
121111111
101510001
141010111
100000001
111011101
100010101
101010111
101000001
111010111
100010001
111111131
