11,9
111111111
101010101
101010101
100010101
101110101
100010001
111010101
100000101
101010111
101010001
111111111
