11,9
111111111
101010001
101010111
100000001
111011101
100010101
101010111
101000001
111010111
100010001
111111111
